111111111111111111111111111111
001110000012000012000002211100
000011000020000010000000000000
000010000000000020000000000000
000000000000000000000000000000
000000000000000000000000000000
000000000000000000000000000000
000000000000000000000000000000
000000000000000000000000000003
111111111111111100011110000111