111111111111111111111111111111
000000000000000000000000000000
000000000000000000000000000000
000000000000000000000000000000
000000000000004403000000000000
000000000000001111000000000000
000000000000400000000400400000
000000440011100000001111100000
040001110000000000000000000004
111000000000000000000000000111