111111111111111111111111111111
001200000000000021010020200000
001000000000000000110000000000
002000000000000000020000000000
000000000001000000000000000000
000000000001000000000000001110
000000000011000000000111000000
000000000001000000000000000000
000440040401000004000040044400
111111111111111111111111111111