111111111111111111111111111111
000000000000000000000000000000
000000000000000000000000000000
000000000000000000000000000000
000041000040000000000000000000
000011001110000000000004000000
004111000000044000000041101003
001111000000011100000011101100
011111000000000000440000001114
111111000000000000111000001111