111111111111111111111111111111
000111100012110000000000101110
000002000000000000000000000010
000000000000000000000000000020
000000000000000000030000000000
000000000000000000110000000000
000000000000000011100000000000
000000000000011100000000000000
000000000000000000000000000000
111111111111111100001111111111