111111111111111111111111111111
001000200001100000001200000000
000000000000000000000000000000
000000000000000000000000000000
000000000000000000000000000000
000000004000000400000000000000
000000001100001100000011000300
000000011000000000000000000000
004440110000000000044000040000
111111100000000011111111111111