111111111111111111111111111111
011100111000000002000011110000
001200020000000000000002200000
000000000000000000000000000000
000000000000000000000000000000
000000000000000000000000000000
000000000000000000000000000000
000000000000000000000000000000
000000000001000010000010000003
111111111111001110011110011111