111111111111111111111111111111
011000000000111012200000010020
001000000000010000000000020000
000000000004404000000000000000
000000000011111030000000000000
000004040000000000000000000030
000111110000000040000000000000
000000000000000111000000000000
044040000040040000000404000400
111111111111111111111111111111